T5 T5 T5 T5 T5 T5 T5 T5 T5 T5 T5 T5 T5 T5 T5 T5
T5 G1 G2 G2 G2 G3 T5 T5 T5 T5 T5 T5 T5 T5 T5 T5
T5 G4 G5 G5 G5 Q3 G3 t1 t2 t2 t3 T5 T5 T5 T5 T5
T5 G4 G5 G5 G5 G5 G6 t4 A5 A5 q3 t2 t2 t2 t3 T5
T5 G4 G5 G5 G5 G5 G6 t7 t8 t8 t8 t8 t8 t8 t9 T5
G2 Q4 G5 G5 G5 G5 Q3 G2 G2 G2 G2 G2 G2 G2 G2 G2
G8 Q2 G5 G5 G5 G5 Q1 G8 G8 G8 Q2 G5 G5 G5 Q1 G8
T5 G4 G5 G5 G5 G5 G6 T5 T5 T5 G4 G5 G5 G5 G6 T5
T5 G4 A1 A2 A3 G5 G6 T5 T5 T5 G4 G5 G5 G5 G6 T5
T5 G4 A4 A5 A6 G5 Q3 G2 G2 G2 Q4 G5 G5 G5 G6 T5
T5 G7 A7 A8 A9 G8 G8 G8 G8 G8 G8 G8 G8 G8 G9 T5
T5 T5 T5 T5 T5 T5 T5 T5 T5 T5 T5 T5 T5 T5 T5 T5