T5 T5 T5 T5 T5 T5 T5 T5 T5 T5 T5 T5 T5 T5 T5 T5
T5 G1 G2 G2 G2 G3 T5 G1 G2 G2 G2 G2 G2 G2 G3 T5
T5 G4 Q1 G8 Q2 G6 T5 G4 Q1 G8 G8 Q2 G5 G5 G6 T5
T5 G4 G6 T5 G4 G6 T5 G4 G6 T5 T5 G4 G5 G5 G6 T5
T5 G4 G6 T5 G4 G6 T5 G4 G6 T5 T5 G4 G5 G5 G6 T5
G2 Q4 G6 T5 G4 Q3 G2 Q4 G6 T5 T5 G4 G5 G5 Q3 G2
G8 G8 G9 T5 G4 G5 G5 G5 G6 T5 T5 G7 G8 G8 G8 G8
T5 T5 T5 T5 G7 Q2 G5 G5 G6 T5 T5 T5 T5 T5 T5 T5
T5 T5 T5 T5 T5 G4 G5 G5 G6 T5 T5 T5 T5 T5 T5 T5
T5 T5 T5 T5 T5 G7 G8 G8 G9 T5 T5 T5 T5 T5 T5 T5
t2 t2 t2 t2 t2 t2 t2 t2 t2 t2 t2 t2 t2 t2 t2 t2
A5 A5 A5 A5 A5 A5 A5 A5 A5 A5 A5 A5 A5 A5 A5 A5