T5 T5 T5 T5 T5 T5 T5 T5 T5 T5 T5 T5 T5 T5 T5 T5
T5 G1 G3 T5 T5 T5 T5 T5 T5 T5 T5 T5 T5 T5 T5 T5
T5 G4 Q3 G2 G3 T5 T5 T5 T5 T5 T5 T5 T5 T5 T5 T5
T5 G4 G5 G5 Q3 G2 G3 T5 T5 T5 T5 T5 T5 T5 T5 T5
T5 G4 G5 G5 G5 G5 Q3 G2 G2 G2 G2 G2 G2 G3 T5 T5
G2 Q4 G5 G5 G5 G5 G5 G5 G5 G5 G5 G5 G5 Q3 G2 G2
G8 Q2 G5 G5 G5 G5 G5 G5 G5 G5 G5 G5 G5 Q1 G8 G8
T5 G4 G5 G5 G5 G5 Q1 G8 G8 G8 G8 G8 G8 G9 T5 T5
T5 G4 G5 G5 Q1 G8 G9 T5 T5 T5 T5 T5 T5 T5 T5 T5
T5 G4 Q1 G8 G9 T5 T5 T5 T5 T5 T5 T5 T5 T5 T5 T5
T5 G7 G9 T5 T5 T5 T5 T5 T5 T5 T5 T5 T5 T5 T5 T5
T5 T5 T5 T5 T5 T5 T5 T5 T5 T5 T5 T5 T5 T5 T5 T5