T5 T5 T5 T5 T5 T5 T5 T5 T5 T5 T5 T5 T5 T5 T5 T5
T5 G1 G2 G2 G2 G2 G2 G2 G2 G2 G2 G2 G2 G2 G3 T5
T5 G4 G5 A1 A3 G5 Q1 G8 G8 G8 G8 Q2 Q1 G8 G9 T5
T5 G4 G5 A4 A6 G5 G6 T5 T5 T5 T5 G4 G6 T5 T5 T5
T5 G4 G5 A7 A9 G5 G6 T5 T5 T5 T5 G4 G6 T5 T5 T5
G2 Q4 G5 G5 G5 G5 Q3 G2 G2 G2 G2 Q4 Q3 G2 G3 T5
G8 Q2 Q1 G8 G8 G8 G8 Q2 Q1 G8 G8 Q2 Q1 G8 G9 T5
T5 G4 G6 T5 T5 T5 T5 G4 G6 T5 T5 G4 G6 T5 T5 T5
T5 G4 G6 T5 T5 T5 T5 G4 G6 T5 T5 G4 Q3 G2 G3 T5
T5 G4 Q3 G2 G2 G2 G2 Q4 G6 T5 T5 G4 G5 G5 G6 T5
T5 G7 G8 G8 G8 G8 G8 G8 G9 T5 T5 G7 G8 G8 G9 T5
T5 T5 T5 T5 T5 T5 T5 T5 T5 T5 T5 T5 T5 T5 T5 T5