T5 T5 T5 T5 T5 T5 T5 T5 T5 T5 T5 T5 T5 T5 T5 T5
T5 G1 G2 G2 G2 G2 G2 G2 G2 G2 G2 G2 G2 G2 G3 T5
T5 G4 G5 G5 G5 G5 G5 G5 G5 G5 G5 G5 G5 G5 G6 T5
T5 G4 G5 A1 A2 A2 A3 G5 G5 G5 G5 G5 G5 G5 G6 T5
T5 G4 G5 A4 A5 A5 A6 G5 G5 G5 G5 G5 G5 G5 G6 T5
G2 Q4 G5 A4 A5 A5 A6 G5 G5 G5 G5 G5 G5 G5 G6 T5
G8 Q2 G5 A7 A8 A8 A9 G5 G5 G5 G5 G5 G5 G5 G6 T5
T5 G4 G5 G5 G5 G5 G5 G5 G5 G5 G5 G5 G5 G5 G6 T5
T5 G4 G5 G5 G5 G5 G5 G5 G5 G5 G5 G5 G5 G5 G6 T5
T5 G4 G5 G5 G5 G5 G5 G5 G5 G5 G5 G5 G5 G5 G6 T5
T5 G7 G8 G8 G8 G8 G8 G8 G8 G8 G8 G8 G8 G8 G9 T5
T5 T5 T5 T5 T5 T5 T5 T5 T5 T5 T5 T5 T5 T5 T5 T5